NO maps/subject_map.cub
SO maps/subject_map.cub
WE maps/subject_map.cub
EA maps/subject_map.cub

C 111,18,49
F 54,54,54

1111111111111111111111111
1000000000000000000010001
1000000000000000000010001
1000000000000000000000001
1000000000000000000010001
1000000000000000000010001
1001000000000000010010001
100110000000S000110010001
1000000000000000000010001
1000000000000000000010001
1111111111111111111111111