NO maps/subject_map.cub
SO maps/subject_map.cub
WE maps/subject_map.cub
EA maps/subject_map.cub

C 111,18,49
F 54,54,54

1111111111111111111111111
1000000000000000000010001
1000000000000000000010001
1000000000000000000000001
1000000000000000000010001
1000000000000000000010001
100100000S000000010010001
1001100000000000110010001
1000000000000000000010001
1000000000000000000010001
1111111111111111111111111