NO maps/subject_map.cub
SO maps/subject_map.cub
WE maps/subject_map.cub
EA maps/subject_map.cub
C 111,18,49
F 54,54,54

1111111111111111111111111
1000000000000000000010001
1000000000000000000010001
10000000000000000000D0001
1000000000000000000010001
10000000N01D1000000010001
1001000000000000010010001
1001100000100000110010001
1000000000D00000000010001
1000000000100000000010001
1111111111111111111111111