NO maps/subject_map.cub
SO maps/subject_map.cub
WE maps/subject_map.cub
EA maps/subject_map.cub
F 20,100,0
C 225,30,0

1111111
10000S1
1000001
1111111